
NO     textures/1.xpm
SO textures/2.xpm
EA textures/3.xpm
WE textures/4.xpm
F      150,110,12

C       200,1,25

11 1   1111
111S111
1111111