
NO north
EA east
SO rida
WE west
F       150,110,12


C        22,100,230

11111111111111111111111111111
11001000000000010000000000001
10010000111000100001000000001
10011000001000110000000000001
10000000001000000000000100001
10100001000000000000000000001
10110001000000000000001000001
10000001000011100000011100001
10000000000000000000001000001
10000000000000001000000000001
10000000000000001000000010001
10011000000000110000001000001
10010000000000100000000000001
10010000111000100000000000001
10000000001000000000000000001
10100001000000000000000000001
10011000000000110000001000001
10010000000000100000000000001
10010000111000100000000000001
10000000001000000000000000001
10100001000000000000000000001
100110000000001111000010000011
100100000000001   1N00000011111
100100001110001111000000000011
10000000001000000000000000001
10100001000000000000000000001
10110001000000000000000000001
11111111111111111111111111111