
NO north
EA east
SO rida
WE west
F       150,110,12


C        22,100,230

11111111111111111111111111111
11001000000000010000000000001
10010000111000100001000000001
10011000001000110000000000001
10000000001000000000000100001
10100001000000000000000000001
10110001000000000000001000001
100000010000111000000111000011
10000000000000000000001000001
10000000000000001000000000001
10000000000000001000000010001
100110000000001100000010000011
10010000000000100000000000001
10010000111000100000000000001
10000000001000000000000000001
101000010000000000000000000011
10011000000000110000001000001
10010000000000100000000000001
10010000111000100000000000001
10000000001000000000000000001
10100001000000000000000000001
100110000000001111010010000011
100100000000001   11N000011111
10010000111000111100000000011
10000000001000000000000000001
10100001000000000000000000001
10110001000000000000000000001
11111111111111111111111111111
