NO textures/1.xpm
SO textures/2.xpm
EA textures/3.xpm
WE textures/4.xpm
F       150,110,12


C        22,100,230

111111111111111
100000100000001
100S011111111111111111111
10000011000000000000010001
10000010000000000000000001
10000011000000000000010001
11101111111011111111110001
110000110000001      10001
100000010000001      10001
100000010000001      10001
11111111111111111111111111
