WE ./textures/1.xpm
EA ./textures/2.xpm
NO ./textures/3.xpm
SO ./textures/4.xpm

F 27,41,90
C 137,207,240

111111111111111111111111111111111111111
100000000000000000000000000000000000001
100000000000000000000000000000000000001
10000000000000E000000000000000000000001
100000000000000000000000000000000000001
100000000000000000000000000000000000001
100000000001100000000000000001100000001
100000000000000000000000000000000000001
100000000000000000000000000000000000001
100000000000000000000000000000000000001
100000000000000000000000000000000000001
100000000000000000000000000000000000001
100000000000000000000000000000000000001
100000000000000000000000000000000000001
100000000000000000000000000000000000001
100000000000000000000000000000000000001
100000000000000000000000000000000000001
100000000001100000000000000000000000001
111111111111111111111111111111111111111
