WE ./textures/01.xpm
EA ./textures/02.xpm
NO ./textures/03.xpm
SO ./textures/04.xpm
C 65,48,89
F 100,0,0

11111111111111111111
10000001000100000001
10N00001111100000001
10000000000000000001
10000000000000000001
10000000000000000001111111111111
10000000000000000000000000000001
10000000000000000001111111111111
10000000000000000001        1001
10000000000000000001        1111
10000000000000000001
10000000000000000001
10000000000000000001
10000000000000000001
10000000111100000001
10000000100100000001
10000000100100000001
11111111111111111111
